111111111111111111111111111111111111111111111111111111111111111111
100P00000000000000000000000000000000000000000000000000000000000001
100000000000000000000000000000000000000000000000000000000000000001
100000000111111000001000000000000011111100000111111110000000000001
100000001000000100001000000000000100000010000100000000000000000001
100000001000000100001000000000000100000010000100000000000000000001
100000001111111100001000000000000111111110000111111110000000000001
100000001000000100001000000000000100000010000100000000000000000001
100000001000000100001000000000000100000010000100000000000000000001
100000001000000100001111111100000100000010000111111110000000000001
100000000000000000000000000000000000000000000000000000000000000001
100000000000000000000000000000000000000000000000000000000000000001
100000000000CCCC00000000CCCCCC0000000CCCCCC000CCCCCCCC000000000001
100000000000000C0000000000000C000000000000C0000000000C000000000001
100000000000000C00000000CCCCCC0000000CCCCCC0000000000C000000000001
100000000000000C0000000000000C000000000000C0000000000C000000000001
100000000000CCCCCC000000CCCCCC0000000CCCCCC0000000000C000000000001
1E0000000000000000000000000000000000000000000000000000000000000001
111111111111111111111111111111111111111111111111111111111111111111
