111111111111111111111111111111111111111111111111111111111111111111
100P00000000000000000000000000000000000000000000000000000000000001
1000000X00000000000000X0000000000000000000000000000000000000000001
10000000011111100X001000000000000011111100000111111110000000X00001
10000X00100000010000100000000000010000001000010000000000X000000001
10000000100000010000100X000000000100000010000100000000000000000001
100000001111111100001000000000000111111110000111111110000000000001
1000X000100000010000100000X0000001000000100001000X0000000000000001
100000001000000100001000000000000100000010000100000000000000000001
10000000100000010X00111111110000010000001000011111111000X000000001
10000000000000000000000000X000000000000000000000000000000000000001
1000000X000000X0000000000000000000000000000000000000000000X0000001
100000000000CCCC00000000CCCCCC0000000CCCCCC000CCCCCCCC000000000001
100000000000000C00X0000000000C000000000000C0000000000C00X000000001
100000000000000C00000000CCCCCC0000000CCCCCC0000000000C000000000001
100000000X00000C0000000000X00C000X00000000C0000000X00C000000X00001
100000000000CCCCCC000X00CCCCCC0000000CCCCCC000X000000C000000000001
1E000000000000000000000000000000000000000000000000000X000000000001
111111111111111111111111111111111111111111111111111111111111111111
