1111111111111111111111111111111111
1E0X00000000000C00000C000000000001
10100101001000X0101001X000X00101X1
101X01001X1010100010010XXX00010101
1P0000000C00C0000000000000000000C1
1111111111111111111111111111111111
